12 15
1111111111111
1000i00020001
1210101210101
1020000000001
1010101210101
1020000000001
1010101010121
1000200000001
1012101010121
1000200000201
1010101010101
1020000000001
1010121010121
10002000o0001
1111111111111