12 15
1111111111111
1000i00000001
1010101010101
1000000000001
1010101010101
1000000000001
1010101010101
1000000000001
1010101010101
1000000000001
1010101010101
1000000000001
1010101010101
10000000o0001
1111111111111